1111111111111111111111111111111111111111
1666666666666666666666666666666666666661
1611111616111111111111111111116161111161
1611111616166666666666666666116161111161
1666666616161111161116111116116166666661
1616111116161111161116111116116111116161
1616611666666666666666666666666661166161
1611611111116161111111111616111111161161
1611611666666161111111111616666661161161
1666666611111161111111111611111166666661
1611111111111161111111111611111111111161
1666666666666666666666666666666666666661
1111111111161111111111111111611111111111
1111111111161111111111111111611111111111
1666666666666661111111111666666666666661
1611111161111161111111111611111611111161
1661111661111161111111111611111661111661
1166666661111166666666666611111666666611
1111111166666661611111161666666611111111
1111111111111111611111161111111111111111
1111111111111111611111161111111111111111
1111111166666661611111161666666611111111
1166666661111166666666666611111666666611
1661111661111161111111111611111661111661
1611111161111161111111111611111611111161
1666666666666661111111111666666666666661
1111111111161111111111111111611111111111
1111111111161111111111111111611111111111
1666666666666666666666666666666666666661
1611111111111161111111111611111111111161
1666666611111161111111111611111166666661
1611611666666161111111111616666661161161
1611611111116161111111111616111111161161
1616611666666666666666666666666661166161
1616111116161111161116111116116111116161
1666666616161111161116111116116166666661
1611111616166666666666666666616161111161
1611111616111111111111111111116161111161
1666666666666666666666666666666666666661
1111111111111111111111111111111111111111
