1111111111111111111111111111111111111111
1666666666666666666666666666666666666661
1611111616111111161111611111116161111161
1611111616166666666666666666116161111161
1666666616161111161111611116116166666661
1616111116161111161111611116116111116161
1616666666666666666666666666666666666161
1611611111116161111111111616111111161161
1611611111116161111111111616111111161161
1611666666666161111111111616666666661161
1611611111111161111111111611111111161161
1666666666666666666666666666666666666661
1111161111161111111111111111611111611111
1111161111161111111111111111611111611111
1666666666666661111111111666666666666661
1611111161111161111111111611111611111161
1611111161111161111111111611111611111161
1666666661111166666666666611111666666661
1111161166666661611111161666666611611111
1111161111161111611111161111611111611111
1111161111161111611111161111611111611111
1111161166666661611111161666666611611111
1666666661111166666666666611111666666661
1611111161111161111111111611111611111161
1611111161111161111111111611111611111161
1666666666666661111111111666666666666661
1111161111161111111111111111611111611111
1111161111161111111111111111611111611111
1666666666666666666666666666666666666661
1611611111111161111111111611111111161161
1611666666666161111111111616666666661161
1611611111116161111111111616111111161161
1611611111116161111111111616111111161161
1616666666666666666666666666666666666161
1616111116161111161111611116116111116161
1666666616161111161111611116116166666661
1611111616166666666666666666116161111161
1611111616111111161111611111116161111161
1666666666666666666666666666666666666661
1111111111111111111111111111111111111111
