OOOOOOOOOOOOOOOOOOOOOOOOOOOOOOOOOOOOOOOO
OX                                    XO
O OOOOO O OOOOOOO OOOO OOOOOOO O OOOOO O
O OOOOO O O                 OO O OOOOO O
O       O O OOOOO OOOO OOOO OO O       O
O O OOOOO O OOOOO OOOO OOOO OO OOOOO O O
O O                                  O O
O OO OOOOOOO O OOOOOOOOOO O OOOOOOO OO O
O OO OOOOOOO O OOOOOOOOOO O OOOOOOO OO O
O OO         O OOOOOOOOOO O         OO O
O OO OOOOOOOOO OOOOOOOOOO OOOOOOOOO OO O
O                                      O
OOOOO OOOOO OOOOOOOOOOOOOOOO OOOOO OOOOO
OOOOO OOOOO OOOOOOOOOOOOOOOO OOOOO OOOOO
O              OOOOOOOOOO              O
O OOOOOO OOOOO OOOOOOOOOO OOOOO OOOOOO O
O OOOOOO OOOOO O        O OOOOO OOOOOO O
O        OOOOO   OOOOOO   OOOOO        O
OOOOO OO       O O    O O       OO OOOOO
      OOOOO OOOO O    O OOOO OOOOO OOOOO
OOOOO OOOOO OOOO O    O OOOO OOOOO      
OOOOO OO       O O    O O       OO OOOOO
O        OOOOO   OOOOOO   OOOOO        O
O OOOOOO OOOOO O        O OOOOO OOOOOO O
O OOOOOO OOOOO OOOOOOOOOO OOOOO OOOOOO O
O              OOOOOOOOOO              O
OOOOO OOOOO OOOOOOOOOOOOOOOO OOOOO OOOOO
OOOOO OOOOO OOOOOOOOOOOOOOOO OOOOO OOOOO
O                                      O
O OO OOOOOOOOO OOOOOOOOOO OOOOOOOOO OO O
O OO         O OOOOOOOOOO O         OO O
O OO OOOOOOO O OOOOOOOOOO O OOOOOOO OO O
O OO OOOOOOO O OOOOOOOOOO O OOOOOOO OO O
O O                                  O O
O O OOOOO O OOOOO OOOO OOOO OO OOOOO O O
O       O O OOOOO OOOO OOOO OO O       O
O OOOOO O O                 OO O OOOOO O
O OOOOO O OOOOOOO OOOO OOOOOOO O OOOOO O
OX                                    XO
OOOOOOOOOOOOOOOOOOOOOOOOOOOOOOOOOOOOOOOO
