OOOOOOOOOOOOOOOOOOOOOOOOOOOOOOOOOOOOOOOO
OX                                    XO
O OOOOO O OOOOOOO OOOO OOOOOOO O OOOOO O
O OOOOO O O                 OO O OOOOO O
O       O O OOOOO OOOO OOOO OO O       O
O O OOOOO O OOOOO OOOO OOOO OO OOOOO O O
O O                                  O O
O OO OOOOOOO O OOOOOOOOOO O OOOOOOO OO O
O OO OOOOOOO O OOOOOOOOOO O OOOOOOO OO O
O OO         O OOOOOOOOOO O         OO O
O OO OOOOOOOOO OOOOOOOOOO OOOOOOOOO OO O
O                                      O
OOOOO OOOOO OOOOOOOOOOOOOOOO OOOOO OOOOO
OOOOO OOOOO OOOOOOOOOOOOOOOO OOOOO OOOOO
O              OOOOOOOOOOO             O
O OOOOOO OOOOO OOOOOOOOOOO OOOO OOOOOO O
O OOOOOO OOOOO O         O OOOO OOOOOO O
O        OOOOO   OOOOOOO   OOOO        O
OOOOO OO       O O     O O      OO OOOOO
      OOOOO OOOO O     O OOO OOOOO OOOOO
OOOOO OOOOO OOOO O     O OOO OOOOO      
OOOOO OO       O O     O O      OO OOOOO
O        OOOOO   OOOOOOO   OOOO        O
O OOOOOO OOOOO O         O OOOO OOOOOO O
O OOOOOO OOOOO OOOOOOOOOOO OOOO OOOOOO O
O              OOOOOOOOOOO             O
OOOOO OOOOO OOOOOOOOOOOOOOOO OOOOO OOOOO
OOOOO OOOOO OOOOOOOOOOOOOOOO OOOOO OOOOO
O                                      O
O OO OOOOOOOOO OOOOOOOOOO OOOOOOOOO OO O
O OO         O OOOOOOOOOO O         OO O
O OO OOOOOOO O OOOOOOOOOO O OOOOOOO OO O
O OO OOOOOOO O OOOOOOOOOO O OOOOOOO OO O
O O                                  O O
O O OOOOO O OOOOO OOOO OOOO OO OOOOO O O
O       O O OOOOO OOOO OOOO OO O       O
O OOOOO O O                 OO O OOOOO O
O OOOOO O OOOOOOO OOOO OOOOOOO O OOOOO O
OX                                    XO
OOOOOOOOOOOOOOOOOOOOOOOOOOOOOOOOOOOOOOOO
